################
#        X     #
#        #######
# P  O ###
#        #
#    X   #
##########
