################
#        X     #
#              #
# P  O         #
#      X       #
#              #
################
